11111111111
11111000031
10100011111
12101110041
10000016111
10101000051
11111111111